 Qwerty
 ,-----------------------------------------------------------------------------------.
 | Tab  |   Q  |   W  |   E  |   R  |   T  |   Y  |   U  |   I  |   O  |   P  | Bksp |
 |------+------+------+------+------+-------------+------+------+------+------+------|
 | Esc  |   A  |   S  |   D  |   F  |   G  |   H  |   J  |   K  |   L  |   ;  |  "   |
 |------+------+------+------+------+------|------+------+------+------+------+------|
 | Shift|   Z  |   X  |   C  |   V  |   B  |   N  |   M  |   ,  |   .  |   /  |Enter |
 |------+------+------+------+------+------+------+------+------+------+------+------|
 | Ctrl | Alt  | GUI  | Lock |Lower |    Space    |Raise | Left | Down |  Up  |Right |
 `-----------------------------------------------------------------------------------'
 
 Colemak
 ,-----------------------------------------------------------------------------------.
 | Tab  |   Q  |   W  |   F  |   P  |   G  |   J  |   L  |   U  |   Y  |   ;  | Bksp |
 |------+------+------+------+------+-------------+------+------+------+------+------|
 | Esc  |   A  |   R  |   S  |   T  |   D  |   H  |   N  |   E  |   I  |   O  |  "   |
 |------+------+------+------+------+------|------+------+------+------+------+------|
 | Shift|   Z  |   X  |   C  |   V  |   B  |   K  |   M  |   ,  |   .  |   /  |Enter |
 |------+------+------+------+------+------+------+------+------+------+------+------|
 | Ctrl | Alt  | GUI  | Lock |Lower |    Space    |Raise | Left | Down |  Up  |Right |
 `-----------------------------------------------------------------------------------'

 Dvorak
 ,-----------------------------------------------------------------------------------.
 | Tab  |   "  |   ,  |   .  |   P  |   Y  |   F  |   G  |   C  |   R  |   L  | Bksp |
 |------+------+------+------+------+-------------+------+------+------+------+------|
 | Esc  |   A  |   O  |   E  |   U  |   I  |   D  |   H  |   T  |   N  |   S  |  /   |
 |------+------+------+------+------+------|------+------+------+------+------+------|
 | Shift|   ;  |   Q  |   J  |   K  |   X  |   B  |   M  |   W  |   V  |   Z  |Enter |
 |------+------+------+------+------+------+------+------+------+------+------+------|
 | Ctrl | Alt  | GUI  | Lock |Lower |    Space    |Raise | Left | Down |  Up  |Right |
 `-----------------------------------------------------------------------------------'

 Raise
 ,-----------------------------------------------------------------------------------.
 |      |      | Home |  UP  | End  |Pg_up |      |      |      |   (  |   )  | Del  |
 |------+------+------+------+------+-------------+------+------+------+------+------|
 |      |      | LEFT | DOWN | RGHT |Pg_dn |      |   -  |   =  |   [  |   ]  |  \   |
 |------+------+------+------+------+------|------+------+------+------+------+------|
 |      |      |      |      |      |      |      |      |      |      |      |      |
 |------+------+------+------+------+------+------+------+------+------+------+------|
 |      |      |      |      |      |     Ins     |      | Home |Pg_dn |Pg_up | End  |
 `-----------------------------------------------------------------------------------'

 Lower
 ,-----------------------------------------------------------------------------------.
 |   `  |  F10 |  F7  |  F8  |  F9  |      |      |   7  |   8  |   9  |      | Del  |
 |------+------+------+------+------+-------------+------+------+------+------+------|
 |      |  F11 |  F4  |  F5  |  F6  |      |      |   4  |   5  |   6  |      |      |
 |------+------+------+------+------+------|------+------+------+------+------+------|
 |      |  F12 |  F3  |  F2  |  F1  |      |      |   1  |   2  |   3  |      |      |
 |------+------+------+------+------+------+------+------+------+------+------+------|
 |      |      |      |      |      |      0      |      | Next | Vol- | Vol+ | Play |
 `-----------------------------------------------------------------------------------'

 Adjust (Lower + Raise)
 ,-----------------------------------------------------------------------------------.
 |      | Reset|      |      |      |      |      |      |      |      |      |  Del |
 |------+------+------+------+------+-------------+------+------+------+------+------|
 |      |      |      |Aud on|Audoff|AGnorm|AGswap|Qwerty|Colemk|Dvorak|      |      |
 |------+------+------+------+------+------|------+------+------+------+------+------|
 |      |Voice-|Voice+|Mus on|Musoff|MIDIon|MIDIof|      |      |      | Click|      |
 |------+------+------+------+------+------+------+------+------+------+------+------|
 |      |      |      |      |      |             |      |      |      |      |      |
 `-----------------------------------------------------------------------------------'